"candles"	["other vegetables",4]
"canned vegetables"	["other vegetables",2]
"frozen chicken"	["herbs",1]
"liquor"	["cream cheese ",2]
"chocolate"	["rolls\/buns",8]
"beverages"	["cream cheese ",3]
"cat food"	["whole milk",3]
"herbs"	["yogurt",4]
"packaged fruit\/vegetables"	["chocolate",2]
"turkey"	["long life bakery product",2]
"berries"	["other vegetables",5]
"chicken"	["whole milk",6]
"jam"	["whole milk",1]
"other vegetables"	["other vegetables",30]
"Instant food products"	["whole milk",2]
"finished products"	["whole milk",2]
"snack products"	["whole milk",1]
"white bread"	["white bread",4]
"whole milk"	["whole milk",28]
"dish cleaner"	["frozen vegetables",2]
"hard cheese"	["coffee",3]
"liqueur"	["onions",1]
"soap"	["pork",1]
"artif. sweetener"	["soda",2]
"cling film\/bags"	["soda",2]
"coffee"	["whole milk",5]
"ice cream"	["rolls\/buns",3]
"pastry"	["whole milk",13]
"pot plants"	["soda",2]
"vinegar"	["frankfurter",1]
"cream"	["butter",1]
"decalcifier"	["rolls\/buns",1]
"frozen potato products"	["whole milk",2]
"nuts\/prunes"	["whole milk",1]
"liver loaf"	["canned vegetables",2]
"oil"	["rolls\/buns",3]
"flour"	["frankfurter",4]
"kitchen towels"	["zwieback",1]
"roll products "	["meat",2]
"salad dressing"	["herbs",1]
"white wine"	["domestic eggs",4]
"canned beer"	["root vegetables",7]
"dog food"	["sausage",2]
"mayonnaise"	["rolls\/buns",5]
"processed cheese"	["whole milk",6]
"soups"	["root vegetables",2]
"organic products"	["tropical fruit",1]
"pork"	["whole milk",7]
"rice"	["whole milk",2]
"sugar"	["curd",3]
"beef"	["yogurt",4]
"bottled beer"	["whole milk",13]
"cocoa drinks"	["canned fish",2]
"hygiene articles"	["sausage",4]
"instant coffee"	["margarine",1]
"mustard"	["whipped\/sour cream",3]
"popcorn"	["frankfurter",1]
"cookware"	["canned beer",1]
"frozen dessert"	["yogurt",2]
"frozen vegetables"	["rolls\/buns",6]
"grapes"	["other vegetables",6]
"photo\/film"	["soda",3]
"pip fruit"	["rolls\/buns",12]
"specialty fat"	["white wine",1]
"zwieback"	["bottled beer",1]
"cereals"	["tropical fruit",1]
"ham"	["whole milk",3]
"rolls\/buns"	["rolls\/buns",24]
"softener"	["whole milk",2]
"meat spreads"	["domestic eggs",1]
"sauces"	["yogurt",1]
"hamburger meat"	["tropical fruit",5]
"napkins"	["margarine",2]
"ready soups"	["flour",1]
"UHT-milk"	["whole milk",5]
"condensed milk"	["tropical fruit",2]
"pickled vegetables"	["soda",2]
"canned fruit"	["brown bread",1]
"seasonal products"	["butter",2]
"skin care"	["tropical fruit",1]
"tea"	["soda",1]
"sparkling wine"	["citrus fruit",1]
"specialty cheese"	["bottled beer",1]
"detergent"	["whole milk",3]
"house keeping products"	["yogurt",2]
"soft cheese"	["whole milk",3]
"pasta"	["pip fruit",2]
"baking powder"	["bottled beer",2]
"flower soil\/fertilizer"	["curd",1]
"candy"	["bottled water",3]
"nut snack"	["bottled water",1]
"soda"	["other vegetables",17]
"domestic eggs"	["soda",10]
"specialty bar"	["other vegetables",4]
"tropical fruit"	["whole milk",15]
"cream cheese "	["other vegetables",5]
"flower (seeds)"	["yogurt",1]
"onions"	["tropical fruit",7]
"specialty chocolate"	["root vegetables",5]
"butter"	["rolls\/buns",8]
"sausage"	["whole milk",13]
"dental care"	["tropical fruit",1]
"frozen fish"	["canned beer",2]
"tidbits"	["pork",1]
"citrus fruit"	["whole milk",8]
"organic sausage"	["tropical fruit",1]
"chewing gum"	["pastry",4]
"cleaner"	["whole milk",2]
"frankfurter"	["rolls\/buns",13]
"hair spray"	["processed cheese",1]
"root vegetables"	["other vegetables",8]
"specialty vegetables"	["canned fish",1]
"abrasive cleaner"	["onions",1]
"female sanitary products"	["whole milk",1]
"prosecco"	["pot plants",1]
"pudding powder"	["waffles",1]
"honey"	["brown bread",1]
"margarine"	["pastry",4]
"pet care"	["brown bread",3]
"frozen meals"	["soda",5]
"long life bakery product"	["other vegetables",4]
"salt"	["domestic eggs",2]
"salty snack"	["soda",5]
"semi-finished bread"	["whole milk",4]
"waffles"	["other vegetables",3]
"curd"	["yogurt",7]
"newspapers"	["whole milk",9]
"rum"	["meat",1]
"syrup"	["newspapers",2]
"brandy"	["soda",3]
"curd cheese"	["pastry",2]
"fish"	["specialty chocolate",2]
"light bulbs"	["curd",1]
"sliced cheese"	["pork",3]
"cake bar"	["canned beer",1]
"dessert"	["shopping bags",5]
"fruit\/vegetable juice"	["whole milk",5]
"rubbing alcohol"	["shopping bags",1]
"spread cheese"	["rolls\/buns",3]
"canned fish"	["shopping bags",2]
"ketchup"	["pastry",3]
"liquor (appetizer)"	["dessert",2]
"male cosmetics"	["meat",1]
"red\/blush wine"	["chicken",4]
"spices"	["other vegetables",2]
"bottled water"	["whole milk",9]
"dishes"	["citrus fruit",2]
"frozen fruits"	["citrus fruit",1]
"whipped\/sour cream"	["soda",6]
"brown bread"	["other vegetables",6]
"yogurt"	["whole milk",17]
"butter milk"	["other vegetables",4]
"misc. beverages"	["sausage",3]
"chocolate marshmallow"	["canned beer",1]
"meat"	["pip fruit",2]
"potato products"	["root vegetables",1]
"shopping bags"	["whole milk",10]
"sweet spreads"	["butter",2]
